        1,1,5,1,1,1,5,1,1,1,5,1,1,1,5,1,1,1,1,1,1,0,0,0,0,0,0,0,0,0,0,0,0
        1,1,1,5,1,1,1,5,1,1,1,5,1,1,1,5,1,1,1,1,2,0,0,0,0,0,0,0,0,0,0,0,0
        1,1,1,5,1,1,1,5,1,1,1,5,1,1,1,5,1,1,1,1,2,0,0,0,0,0,0,0,0,0,0,0,0
        1,1,5,1,1,1,5,1,1,1,5,1,1,1,5,1,1,1,1,1,1,0,0,0,0,0,0,0,0,0,0,0,0
        1,1,5,1,1,1,5,1,1,1,5,1,1,1,5,1,1,1,1,1,1,0,0,0,0,0,0,0,0,0,0,0,0
        1,1,5,1,1,1,5,1,1,1,5,1,1,1,5,1,1,1,1,1,1,0,0,0,0,0,0,0,0,0,0,0,0
        1,1,5,1,1,1,5,1,1,1,5,1,1,1,5,1,1,1,1,1,1,0,0,0,0,0,0,0,0,0,0,0,0
        1,1,5,1,1,1,5,1,1,1,5,1,1,1,5,1,1,1,1,1,1,0,0,0,0,0,0,0,0,0,0,0,0
        -1,1,1,5,1,1,1,5,1,1,1,5,1,1,5,1,1,1,1,1,2,0,0,0,0,0,0,0,0,0,0,0,0
        1,1,1,5,1,1,1,5,1,1,1,5,1,1,1,5,1,1,1,1,2,0,0,0,0,0,0,0,0,0,0,0,0
        1,1,1,5,1,1,1,5,1,1,1,1,1,1,1,5,1,1,1,1,1,11,11,11,11,11,11,11,11,11,11,11,11
        1,1,1,5,1,1,1,5,1,1,1,5,1,1,1,5,1,1,1,1,1,11,11,11,11,11,11,11,11,11,11,11,12
        1,1,1,5,1,1,1,1,1,1,1,5,1,1,1,5,1,1,1,1,1,11,11,11,11,11,11,11,11,11,11,11,11
        1,1,1,5,1,1,1,5,1,1,1,5,1,1,1,5,1,1,1,1,1,11,11,11,11,11,11,11,11,11,11,11,12
        1,1,1,5,1,1,1,5,1,1,1,5,1,1,1,5,1,1,1,1,1,11,11,11,11,11,11,11,11,11,11,11,11
        1,1,1,5,1,1,1,5,1,1,1,5,1,1,1,1,1,1,1,1,1,11,11,11,11,11,11,11,11,11,11,11,11
        1,1,1,5,1,1,1,5,1,1,1,5,1,1,1,5,1,1,1,1,2,0,0,0,0,0,0,0,0,0,0,0,0
        1,1,1,5,1,1,1,5,1,1,1,5,1,1,1,5,1,1,1,1,2,0,0,0,0,0,0,0,0,0,0,0,0
        1,1,1,1,1,1,1,5,1,1,1,5,1,1,1,5,1,1,1,1,1,0,0,0,0,0,0,0,0,0,0,0,0
        1,1,1,5,1,1,1,5,1,1,1,5,1,1,1,5,1,1,1,1,1,0,0,0,0,0,0,0,0,0,0,0,0
        1,1,1,5,1,1,1,5,1,1,1,5,1,1,1,5,1,1,1,1,1,0,0,0,0,0,0,0,0,0,0,0,0
        0,0,0,0,0,0,0,0,0,0,0,0,0,0,0,21,21,21,21,21,21,0,0,0,0,0,0,0,0,0,0,0,0
        0,0,0,0,0,0,0,0,0,0,0,0,0,0,0,21,21,21,21,21,21,0,0,0,0,0,0,0,0,0,0,0,0
        0,0,0,0,0,0,0,0,0,0,0,0,0,0,0,21,21,21,21,21,21,0,0,0,0,0,0,0,0,0,0,0,0
        0,0,0,0,0,0,0,0,0,0,0,0,0,0,0,21,21,21,21,21,21,0,0,0,0,0,0,0,0,0,0,0,0
        0,0,0,0,0,0,0,0,0,0,0,0,0,0,0,21,21,21,21,21,21,0,0,0,0,0,0,0,0,0,0,0,0
        0,0,0,0,0,0,0,0,0,0,0,0,0,0,0,21,21,21,21,21,21,0,0,0,0,0,0,0,0,0,0,0,0
        0,0,0,0,0,0,0,0,0,0,0,0,0,0,0,21,21,21,21,21,21,0,0,0,0,0,0,0,0,0,0,0,0
        0,0,0,0,0,0,0,0,0,0,0,0,0,0,0,21,21,22,22,22,21,0,0,0,0,0,0,0,0,0,0,0,0
